mal – badly
orden – order
orden – sequence (m), religious
don – courtesy title (m), Mr, gift
semana – week
suponer – to suppose, assume
comprender – to understand
final – finally
al final – in the end
interés – interest
siguiente – following, next
vista – view, sight
lograr – to achieve, get, manage
demás – the rest, others
acuerdo – accord
de acuerdo – in agreement, according
difícil – difficult, hard
número – number
explicar – to explain
negro – black
fondo – bottom, end
camino – road, route, path
voz – voice
estudio – study, learning
necesario – necessary
preguntar – to ask (a question)
allá – there, over there
tocar – to touch, play (instrument)
valor – value, worth
reconocer – to recognize, admit
estudiar – to study
alcanzar – to reach, catch up with
nacer – to be born
dirigir – to direct, manage
correr – to run
medida – measure
a medida que – as (to the..?)
menor – younger, youngest
demasiado – too much, too many
solamente – only
bueno – well...
utilizar – to use, utilize
centro – center, middle, downtown
necesidad – necessity, need
condición – condition
pagar – to pay
ello – it (subj-n)
falta – lack, shortage
ayudar – to help
diez – ten
través, a través  – across, over, through
antiguo – old, ancient, former
tu – your (sg/+fam)
edad – age
estado – state, condition, status
ser – being
gustar – to be pleasing to
puerta – door
jugar – to play (sport/game)
cara – face, expression
mí – me (obj prep)
época – time, age, period
color – color
escuchar – to listen to
experiencia – experience
movimiento – movement
cumplir – to fulfill
especial – special
diferente – different, separate
pesar – sorrow
a pesar de – in spite of
posibilidad – possibility
ofrecer – to offer, present
descubrir – to discover
anterior – previous, preceding
juego – game, play, sport
levantar – to raise, lift
levantarse – to get up
pobre – poor
aire – air, wind, appearance
seis – six
intentar – to try, attempt
guerra – war, warfare
junto – together with, next to
resultado – result, outcome
usar – to use
decidir – to decide
repetir – to repeat
olvidar – to forget
ley – law, bill, rule
aspecto – aspect, appearance
pie – foot, base
valer – to be worth, cost
especie – kind, sort, species
comer – to eat
servicio – service, helpfulness
cerca – close, near
mostrar – to show
actividad – activity, action
tercero – third
cuál – which?
pronto – soon, quick
ocupar – to occupy, use
cuestión – question, matter
duda – doubt
diferencia – difference
mañana – morning, tomorrow
mover – to move, incite
continuar – to continue
cantidad – quantity, amount
acción – action, act, deed
suceder – to happen
fijar – to set, fix, [se] notice
sociedad – society
referir – to refer (to)
acercar – to come near
capaz – capable, able
bajo – short, low
libre – free, vacant
natural – natural
dedicar – to dedicate, devote
realmente – really, actually, in fact
peso – peso (money), weight, load
efecto – effect
objeto – object, thing
verdadero – true, real
dónde – where?
aprender – to learn
amor – love
muerte – death
partido – party, group, (sports) match
económico – economic
derecho – right, justice, law
poder – power
importancia – importance
sistema – system
viaje – travel, trip
suelo – ground, floor
respecto – respect
con respecto a – with regard to, regarding, in relation to, with respect to
conocimiento – knowledge
libertad – freedom, liberty
encima – above, on top, in addition
comprar – to buy
común – common
abierto – open, unlocked
próximo – next
atención – attention
joven – young
subir – to go up
esfuerzo – effort, endeavor
pasado – past, last
evitar – to avoid, prevent
resto – rest, remainder, leftover
interesar – to interest
zona – area, zone
miedo – fear
fuera – out, outside, away
proceso – process, procedure
vivo – alive, bright
cerrar – to close
echar – to throw, cast
responder – to answer, respond
sufrir – to suffer, undergo
completo – complete
minuto – minute
contrario – contrary, opposite
mesa – table, board
real – royal, real, authentic
ocasión – opportunity, occasion
importar – to matter, import
público – public
obtener – to obtain
programa – program, plan
favor – favor, benefit
lejos – far (away, off)
siete – seven
enorme – enormous, vast
respuesta – answer, reply
línea – line, course
espacio – space, room
nivel – level
gobierno – government
cabo – end, bit
llevar a cabo – to carry out
observar – to observe
indicar – to indicate
alguien – somebody, someone,
pregunta – question
claro – of course, clearly
atrás – back, behind, ago
imagen – image, picture
carrera – career, course, race
imaginar – to imagine
soler – to be accustomed to
ambos – both
profundo – deep, profound
detener – to stop, detain
desarrollar – to develop
ocho – eight
señalar – to point (out), signal
elegir – to choose, elect
figura – figure
principal – main, principal
animal – animal
base – base, basis
preparar – to prepare
proponer – to propose
demostrar – to show, demonstrate
significar – to mean
posición – position
motivo – motive, cause
prueba – proof, trial, test
política – politics, policy
nacional – national
lleno – full, filled
reunir – to gather, meet, collect
faltar – to be lacking
supuesto – supposed
por supuesto – of course
acompañar – to accompany
dato – data, fact
fácil – easy
desear – to want, desire, wish for
adelante – forward, further
empresa – firm, company, venture
asunto – matter, issue, affair
presencia – presence, appearance
suyo – his, hers, yours (- fam),
cultura – culture
serie – series
millón – million, fortune
enseñar – to teach, show
construir – to construct, build
vender – to sell
representar – to represent
desaparecer – to disappear, vanish
mandar – to send, order
carácter – personality, nature
mayoría – majority
escuela – school
rojo – red
tras – after, behind
superior – superior, upper
andar – to walk, function
corto – short, brief
autor – writer, author
hermano – brother, [pl] siblings
conocido – known, well-known
preferir – to prefer
asegurar – to assure, secure, insure
función – function, meeting
arriba – up, above
serio – serious
causa – cause
suficiente – sufficient, enough
grave – serious, solemn
decisión – decision
música – music
extraño – strange, foreign
crecer – to grow, increase
surgir – to appear, spring (forth)
tú – you (subj-sg/+fam)
expresión – expression
alrededor – about, around, round
matar – to kill
entregar – to deliver
río – river
seguridad – security, safety
término – term (language), end
colocar – to place, position
metro – meter, subway
médico – doctor
establecer – to establish
guardar – to keep, save
arte – art, skill
iniciar – to initiate, start
bajar – to come down, let down
consecuencia – consequence
notar – to notice
acto – act, action
meter – to put (into)
absoluto – absolute
pena – trouble
valer la pena – to be worth the effor, (be of worth..?)
actuar – to act
segundo – second
altura – height, altitude
deseo – desire, wish
precisamente – precisely
joven – teenager, young person
veinte – twenty
sueño – dream, sleep
pretender – to attempt
tarea – task, job
carta – letter, (playing) card
apenas – hardly, barely
propiedad – property
producto – product
personal – personal
simplemente – simply, just
imposible – impossible
gusto – pleasure, taste, preference
ayuda – help, aid
acordar – to remember, remind
lengua – language, tongue, strip (of land)
cortar – to cut
plan – plan
corresponder – to correspond with
vuelta – return, turn