romper – to break
siquiera – even (if)
adquirir – to acquire, get
proyecto – project, plan
memoria – memory
origen – origin, cause
elemento – element
inglés – English
mercado – market
curso – course, direction
lanzar – to throw, launch
aprovechar – to take advantage of
sangre – blood
interior – interior, inside
duro – hard
apoyar – to support, lean on
negar – to deny, refuse
avanzar – to advance, progress
uso – use
brazo – arm
profesor – professor, teacher
resolver – to resolve, settle, work out
futuro – future
oportunidad – opportunity, chance
mitad – half, middle
costar – to cost, be hard
rico – rich, tasty
recuerdo – memory, keepsake
total – total, entire
exigir – to demand
abajo – down, below, downward
opinión – opinion, view
aumentar – to increase
recoger – to pick up
boca – mouth, entrance, opening
dirección – direction, address
puro – pure, clean
abandonar – to abandon, leave (a place)
pieza – piece, part
profesional – professional
imponer – to impose, enforce
obligar – to obligate, force
físico – physical
actitud – attitude
mar – sea
francés – French
entrada – entrance, admission ticket
contacto – contact
corazón – heart, core
aplicar – to apply
capital – capital, city (f), money (m)
rápido – quick, fast
título – title, heading
pertenecer – to belong
cuarto – room, chamber
material – material, element
golpe – hit, strike, punch
disponer – to have means, dispose
comunicación – communication
expresar – to express
simple – simple, mere, simple-minded
totalmente – totally, completely
provocar – to cause, provoke
normal – normal, usual, regular
defender – to defend, protect
enfermedad – illness, sickness
bien – goods, property, benefit
materia – matter, subject
quitar – to remove, take away
conservar – to conserve, preserve
moderno – modern
sitio – place, space
depender – to depend on
naturaleza – nature, character
capacidad – capacity
actual – current
marcar – to mark, note, dial
distancia – distance
pleno – complete, full
cerrado – closed
compartir – to share
información – information
ambiente – environment, atmosphere
especialmente – especially
desarrollo – development
sol – sun
muerto – dead
consistir – to consist of
constituir – to constitute, consist of
dispuesto – willing, ready
cubrir – to cover
funcionar – to work, function
compañero – companion, classmate
salida – exit, escape, outcome
caber – to fit (into)
conciencia – conscience, consciousness
atender – to serve, attend to
enfermo – ill, sick
insistir – to insist on
costumbre – habit, custom, usage
detrás – behind
paz – peace
noticia – news
circunstancia – circumstance
dolor – pain, ache, sorrow
privado – private
estilo – style
precio – price, cost, value
popular – popular
sentar – to sit (down), seat
planta – plant, floor
personaje – character (e.g. movie)
famoso – famous, well-known
éxito – success
hija – daughter
merecer – to deserve, be worthy (of)
edificio – building
autoridad – authority
piedra – stone, rock
induir – include
conjunto – group, set
treinta – thirty
cuanto – how much?
inmeiato – immediate
suerte – luck, fortune
cruzar – to cross
tender – to tend to, lay out
finalmente – finally, at last
junto – together
anunciar – to announce, advertise
espíritu – spirit, ghost
miembro – member, limb
directo – direct, straight
despertar – to wake (up), arouse
recurso – resource, recourse, means
pared – (interior) wall
equipo – team, equipment, outfit
error – error, mistake
preciso – precise, necessary
diverso – different, several, diverse
dificultad – difficulty, obstacle
comentar – to comment on
publicar – to publish
familiar – familiar, of the family
voluntad – will, willpower, intention
reunión – meeting, reunion
modelo – model, pattern
cargar – to load (up), carry
fecha – date, day
participar – to participate
impedir – to prevent, hinder
propósito – intention, purpose
salvar – to save, rescue
cuidado – care, carefulness
puesto – job, place, position
grado – degree, grade
escapar – to escape
lucha – fight, struggle, wrestle
tirar – to throw, pull
entero – entire, whole, complete
jefe – leader, boss, manager
interesante – interesting
amplio – wide, ample, broad
contestar – to answer, reply
periódico – newspaper, periodical
preocupar – to worry
prestar – to lend
par – pair, couple
a la par – at the same time, together
público – public, audience
pesar – to weigh
final – final
calidad – quality
exponer – to expound, expose
civil – civil
ciencia – science, knowledge
tamaño – size, dimension
mas – but, however
doctor – doctor
cuadro – painting, picture
caballo – horse
responsabilidad – responsibility
cincuenta – fifty
interno – internal
detalle – detail
marcha – march, progress
nueve – nine
carne – meat, flesh
jamás – never
pensamiento – thought, thinking
viajar – to travel
cargo – position, charge, fee
separar – to separate
santa – saint
construcción – construction
juicio – judgment
terreno – ground, earth, terrain
piso – floor, story
compañía – company
regresar – to return
texto – text
fuente – source, fountain
presente – present
definitivo – definitive, conclusive
revista – magazine, journal
esperanza – hope
máquina – machine
contemplar – to contemplate
recorrer – to travel, cover (distance)
frase – phrase
perfecto – perfect
sala – room, hall
durar – to last
instrumento – instrument
aquello – that over there
defensa – defense, plea
director – director, manager, principal
retirar – to take away, retire
explicación – explanation
artículo – article, product, item
debajo – underneath, below
permanecer – to stay, remain
asistir – to attend
doce – twelve
radio – radio, set, communication
organizar – to organize
película – movie, film
elección – election, choice
visita – visit, visitor, guest
contener – to contain
apoyo – support, backing
presidente – president
arma – weapon
árbol – tree
visitar – to visit
informar – to inform
encuentro – meeting, game, skirmish
parecido – similar
corriente – current, flow
lectura – reading
existencia – existence, life
lenguaje – language, speech
enviar – to send
aun – even, still
destino – destination, destiny
educación – education
cuidar – to take care of
intervenir – to intervene
operación – operation
raro – strange, rare, scarce
perfectamente – perfectly
extender – to extend, spread
comprobar – to verify, prove
nota – note, grade
particular – particular, peculiar
ése – that one
militar – military
dormir – to sleep
unido – united
discutir – to argue, discuss
extraordinario – extraordinary, exceptional
teatro – theater, drama
enfrentar – to confront, face
recién – recently, just
negocio – business, transaction
letra – letter, handwriting, lyrics
peor – worse
sentimiento – feeling, sentiment
conducir – to lead, drive
completamente – completely
firmar – to sign
solución – solution, answer
mío – mine
comida – food, meal
impresión – impression, printing
plano – plane, map, level
intención – intention
ritmo – rhythm
verde – green
exacto – exact, faithful, true
respetar – to respect
banco – bank, bench
inmediatamente – immediately
sostener – to support, hold up
piel – skin, hide, fur
delante – front (of), ahead
religioso – religious
advertir – to notice, warn
oscuro – dark, obscure
control – control
investigación – investigation
transformar – to transform, change
conversación – conversation
verano – summer
respeto – respect, regard
norte – north
mediante – by means of
cuarto – fourth
tradición – tradition
bastar – to be sufficient
población – population