pareja – couple, pair
pasado – past
diario – newspaper
azul – blue
mencionar – to mention, cite
generación – generation
frío – cold
visión – vision
concreto – concrete, real
plantear – to propose, present
probar – to test, prove, try
derecho – right, straight
peligro – danger, menace
oro – gold
justo – just
manejar – to drive, handle
vino – wine
unir – to unite, join
caminar – to walk
coincidir – to coincide, agree
etapa – stage, period
sencillo – simple, plain, easy
silencio – silence
salvo – except (for), but
llenar – to fill
dominar – to dominate, master
determinado – determined, fixed
artista – artist, performer
medir – to measure
labor – labor, work, task
perdido – lost
cielo – sky, heaven, ceiling
práctica – practice, skill
límite – limit
masa – mass, dough, bulk, crowd
directamente – directly, straight away
atravesar – to cross
formación – formation, education
perro – dog
izquierda – left
destacar – to emphasize, stand out
cercano – near
cuarenta – forty
pronunciar – to pronounce
distinguir – to distinguish
energía – energy, power
confianza – confidence, trust
adecuado – adequate, suitable
introducir – to introduce, bring in
flor – flower
esposa – wife
comunicar – to communicate
italiano – Italian
invitar – to invite
responsable – responsible
feliz – happy, fortunate
revolución – revolution
instalar – to install
tardar – to delay, take long
mejorar – to improve, get better
maestro – teacher (m), master
emplear – to employ
alemán – German
convenir – to be agreeable, be convenient
recuperar – to recuperate, recover
fenómeno – phenomenon
presión – pressure
dado – given
alumno – student, pupil
teoría – theory
probablemente – probably
tono – tone
salud – health
definir – to define
superar – to overcome, surpass
señora – Mrs., lady, madam
exactamente – exactly
afirmar – to assert, affirm
diario – daily
histórico – historical
debido – due
debido a – due to, because of, on account of
por, vía – by means (road, way, travel)
interpretar – to interpret
alma – soul
admitir – to admit
identificar – to identify
madera – wood
fiesta – party, feast
calor – heat, warmth
mínimo – minimum
afectar – to affect
hogar – home, hearth
mente – mind
seguramente – surely, securely
preocupación – worry, concern
reducir – to reduce
concepto – concept
montar – to ride, mount, assemble
teléfono – phone, telephone
hoja – sheet, leaf
parar – to stop (moving)
doble – double
devolver – to return, give back
ejercer – to practice, exercise
poseer – to possess, own
proteger – to protect
causar – to cause, bring about
rápidamente – rapidly, quickly
determinar – to determine, decide
fuerte – strong
escritor – writer
intento – attempt, try
cobrar – to charge (money)
regla – rule, ruler, regulation
dividir – to divide
riesgo – risk
policía – police, police force, police officer
intventar – to invent, make up
estudiante – student
plaza – square, marketplace
limitar – to limit
llamada – call, knock
sensación – sensation, feeling
enemigo – enemy
unidad – unit, unity
luchar – to fight, wrestle
idioma – language
raíz – root
compromiso – compromise, engagement
comentario – remark, comment
carga – load, charge, cargo
marido – husband
quince – fifteen
constante – constant
derecha – right, right hand
extremo – edge, border, end
individuo – individual, person
contenido – contents, content
semejante – similar, such, alike
obligación – obligation
corte – court (f), cut (m)
extranjero – foreign, alien
total – total
acudir – to attend, go to, frequent
daño – harm, injury, damage
tarde – late
mensaje – message
analizar – to analyze
lista – list, roster, roll
región – region
evidente – evident, obvious
niña – child, young girl
culpa – blame, fault
encargar – to entrust, take charge of
discusión – discussion, argument
pelo – hair
destinar – to assign, appoint
comparar – to compare
celebrar – to celebrate
fe – faith
fijo – fixed, steady
central – central
referencia – reference, allusion
sur – south
gesto – gesture
perspectiva – perspective
preparado – prepared
sonar – to sound, ring
manifestar – to express, show
controlar – to control
saltar – to jump, leap, hop
acaso – by chance, maybe
colegio – school, college
inmenso – immense, vast, huge
venta – sale
documento – document
citar – to cite, quote
televisión – television
chico – boy
novela – novel
requerir – to require
moral – moral
alcance – reach, scope
curioso – curious, strange
crisis – crisis
fundamental – fundamental
incorporar – to incorporate, include
presente – present, current
máximo – maximum
literatura – literature
batalla – battle
europeo – European
dueño – owner, landlord
perseguir – to persecute, pursue, chase
vecino – neighbor
sector – sector, area, section
pintura – painting, paint
accidente – accident, irregularity
oficial – official, authorized
procurar – to try, seek
numeroso – numerous
influencia – influence
intelectual – intellectual
empleado – employee
casar – to marry
prácticamente – practically
moneda – coins, currency
facilidad – ease, facility
matrimonio – marriage, married couple
escaso – scarce, very little
iglesia – church
ayer – yesterday
oficina – office
cristiano – Christian
institución – institution
someter – to subject
fundar – to found, base
seguro – safe, sure, secure
intenso – intense, acute
frío – cold
domingo – Sunday
reacción – reaction
elevar – to elevate, raise
cantar – to sing
acontecimiento – event, happening
costa – coast
peligroso – dangerous
lento – slow
método – method
comunidad – community
coche – car, carriage
asumir – to assume, take on
aclarar – to clarify, clear up
arrastrar – to drag, pull
página – page
declarar – to declare, testify
frecuencia – frequency
conclusión – conclusion, end
escena – scene, stage, setting
falso – false
estructura – structure
beneficio – benefit, profit
alimento – food, nourishment
tranquilo – calm, tranquil, relaxed
velocidad – speed, velocity
barrio – neighborhood, district
nombrar – to name, appoint
análisis – analysis
confundir – to confuse
frontera – border, frontier
describir – to describe
lejano – distant
breve – brief, short
temor – fear
calcular – to calculate, figure out
conformar – to conform
ataque – attack, raid
pintar – to paint
cine – cinema, US movie theater
rama – branch, bough, limb
repartir – to divide, deliver, distribute
comienzo – start, beginning
exterior – exterior, outside
barco – boat, ship
partida – game, match, departure
hallar – to find (out)
ordenar – to put in order, organize
aparato – apparatus, device
convencer – to convince, persuade
médico – medical
extranjero – foreigner
cámera – camera, chamber
creación – creation
rodear – to surround
ajeno – not belonging to, detached
reflejar – to reflect
gana – desire
seco – dry, arid
quinto – fifth
moda – fashion, form
absolutamente – absolutely, completely
rechazar – to reject
contribuir – to contribute
ruido – noise
cama – bed (furniture)
infantil – of children, childlike, infantile
técnica – technique, skill
consejo – advice, council, counsel
internacional – international
violencia – violence
original – original
sonido – sound
vencer – to overcome, conquer
estrella – star
útil – useful
alejar – to move away
mirada – gaze, look
tremendo – tremendous, dreadful, huge
cuándo – when?
temprano – early