El segundo – Second
El minuto – Minute
La hora – Hour
El día – Day
La semana – Week
El mes – Month
El año – Year
La década – Decade
El siglo – Century
El milenio – Millennium
¿Qué hora es? / ¿Qué horas son? – What time is it?
Son las (tres) / es la (una) – It's (three o'clock) / it's one o'clock
En punto – O'clock
(Tres) y media – Half past (three)
(Tres) y cuarto – A quarter past (three)
(Tres) menos cuarto / un cuarto para (las tres) – A quarter to (three)
¿A qué hora...? – At what time...?
La medianoche – Midnight
El mediodía – Noon
Temprano – Early
Tarde – Late
Anoche – Last night
La semana pasada – Last week
Ayer – Yesterday
Anteayer / antes de ayer – The day before yesterday
Pasado mañana – The day after tomorrow
La semana próxima / la semana que viene – Next week
El mes pasado – Last month
El año pasado – Last year
(El) lunes – Monday
(El) martes – Tuesday
(El) miércoles – Wednesday
(El) jueves – Thursday
(El) viernes – Friday
(El) sábado – Saturday
(El) domingo – Sunday
Enero – January
Febrero – February
Marzo – March
Abril – April
Mayo – May
Junio – June
Julio – July
Agosto – August
Septiembre – September
Octubre – October
Noviembre – November
Diciembre – December
El invierno – Winter
El verano – Summer
La primavera – Spring
El otoño – Fall / autumn
El reloj – Clock / watch
La época – Era
La zona horaria – Time zone
La fecha – Date
El horario – Schedule
La madrugada – Dawn, early morning
La temporada – Season
La estación – Season (of the year)
El pasado – Past
El presente – Present
El futuro – Future
El calendario – Calendar
El cronómetro – chronometer, stopwatch